-28
112
-10
37
000000000000000000000000000000000000000000000000000000000000000000000000000000000000000000000000000000000000000000000000000000000000000000000
000000000000000000000000000000000000000000000000001111111111111111111111111111111000000000000000000000000000000000000000000000000000000000000
000000000000000000000000000000000000000000000000010000000000000000000000000000001000000000000000000000000000000000000000000000000000000000000
000000000000000000000000000000000000000000000000010000000000000000000000000000001000000000000000000000000000000000000000000000000000000000000
000000000000000000000000000000000000000000000000010000000000000000000000000000001000000000000000000000000000000000000000000000000000000000000
000000000000000000000000000000000000000000000000010000000000000000000000000000001000000000000000000000000000000000000000000000000000000000000
000000000000000000000000000000000000000000000000010000000000000000000000000000001000000000000000000000000000000000000000000000000000000000000
000000000000000000000000000000000000000000000000010000000000000000000000000000001000000000000000000000000000000000000000000000000000000000000
000000000000000000000000000000000000000000000000010000000000000000000000000000001000000000000000000000000000000000000000000000000000000000000
000000000000000001111111111111111111111111111111110000000000000000000000000000001000000000000000000000000000000000000000000000000000000000000
000000000000000001000000000000000000000000000000000000000000000000000000000000001000000000000000000000000000000000000000000000000000000000000
000000000000000001000000000000000000000000000000000000000000000000000000000000001000000000000000000000000000000000000000000000000000000000000
000000000000000001000000000000000000000000000000000000000000000000000000000000001000000000000000000000000000000000000000000000000000000000000
000000000000000001000001111111111111111111000000101000000000000000000000000000001000000000000000000000000000000000000000000000000000000000000
000000000000000001000001010000000000000001000001111100000000000000000000000000001000000000000000000000000000000000000000000000000000000000000
000000000000000001000001010000000000000001000001111100000111110111110000000000001000000000000000000000000000000000000000000000000000000000000
000000000000000001000001010000000000000001000001111100000000000000000000000000001000000000000000000000000000000000000000000000000000000000000
000000000000000001000000110001111111111111000001111100000000000000000000000000001000000000000000000000000000000000000000000000000000000000000
000000000000000001000000000001000000000000000001111100000111110111110000000000001000000000000000000000000000000000000000000000000000000000000
000000000000000001000000000001000000000000000001111100000000000000000000000000001000000000000000000000000000000000000000000000000000000000000
000000000000000001000000110001111111111111001111111100000000000000000000000000001000000000000000000000000000000000000000000000000000000000000
000000000000000001000011010000000000000001001111111100000111110111110000000000001000000000000000000000000000000000000000000000000000000000000
000000000000000001000011010000000000000001001111111100000000000000000000000000001111111111111111111111111000000000000000000000000000000000000
000000000000000001000011010000000000000001000000000000000000000000000000000000000000000000000000000000001011111111111111111111111111111111100
000000000000000001000011111111111111111111000000000000000000000000000000000000000000000000000000000000001010000000000000000000000110000000100
000000000000000001000000110000000000000000000000000000000000000000000000000000000000000000000000000000001010000000000000000000000000000000100
000000000000000001000000000000000000000000000000000000000000000000000000000000000000000000000000000000001010001101101101101101101100000011100
111111111111111111000000000000000000000000000000000000000000000000000000000000000000000000000000000000001010001101101101101101101100000011100
101101101101100000000000000000000000000000000000000000000000000000000000000000000000000000000000000000001010000000000000000000000000000011100
100100100100100000000111111111000000111111111000000111111111000000000000000000111111111111111111100000001010000000000000000000000000000011100
101101101101100011100111111111001000111111111001000111111111001000000000000000111000000000001011100000001010001101101101101101101100000011100
100100100100100011100111111111001000111111111001000111111111001000000000000000111000000000000011100000001010001101101101101101101100000011100
100000000000000011100000000000001000000000000001000000000000001000000000000000100000000000000000100000001010000000000000000000000000000011100
100000000000000011100000011100011000000011100011000000011100011000000000000000100000000000000000000000001110000000000000000000000000000011100
100000000000000011100000000000001000000000000001000000000000001000000000000000100000111111000000000000000000001101101101101101101100000011100
100000000000000011111110000011111011110000011111011110000011111000000000000011100000111111000000000000000000001101101101101101101100000011100
100000000000000011110100000001011010100000001011010100000001011000000000000000100000111111000000000000001110000000000000000000000000000011100
100100100100100011100000000000001000000000000001000000000000001110000000000000100000111111000000000000001010000000000000000000000000000011100
101101101101100011111110000011111011110000011111011110000011111110000000000000100000000000001111100000001010001101101101101101101100000011100
100100100100100000110100000001011010100000001011010100000001011000000000000100100000000000001000100000001010001101101101101101101100000011100
101101101101100100100000000000001000000000000001000000000000001000000000000100100000000000001011100000001010000000000000000000000000000011100
111111111111111111111110000011111011110000011111011110000011111000000000000000111111111111111111100000001010001101101101101101101100000011100
000000000000000000110100000001011010100000001011010100000001011000110000000000100000000000000000100000001010001101101101101101101100000011100
000000000000000000100000000000001000000000000001000000000000001000110000011000100000000000000000100000001010000000000000000000000000000011100
000000000000000000111110000011111011110000011111011110000011111110000000011011100000000000000000100000001010000000000000000000000000000000100
000000000000000000110100000001011010100000001011010100000001011110000000000011100000000000000000100000001010000000000000000000000000000000100
000000000000000000100000000000001000000000000001000000000000001010000000000001100000000000000000111111111011111111111111111111111111111111100
000000000000000000111111111111111111111111111111111111111111111111111111111111100000000000000000000000000000000000000000000000000000000000000
